10 10
09 19 19 20 20 20 20 20 20 14
17 36 36 36 36 36 36 36 36 12
17 36 36 36 36 36 36 36 36 12
17 36 36 36 36 36 36 36 36 12
17 36 36 36 36 36 36 36 36 12
17 36 36 36 36 36 36 36 36 12
17 36 36 36 36 36 36 36 36 12
17 36 36 36 36 36 36 36 36 12
17 36 36 36 36 36 36 36 36 12
42 44 44 44 44 44 43 43 43 45

t t t t t t t t t t
t t t t t t t t t t
t t t t t t t t t t
t t t t t t t t t t
t t t t t t t t t t
t t t t t t t t t t
t t t t t t t t t t
t t t t t t t t t t
t t t t t t t t t t
t t t t t t t t t t