15 15
09 19 19 20 20 20 20 20 20 20 20 20 20 20 14
17 36 36 36 36 36 36 36 36 36 36 36 36 36 12
17 36 36 36 36 36 36 36 36 36 36 36 36 36 12
17 36 36 36 36 36 36 36 36 36 36 36 36 36 12
17 36 36 36 36 36 36 36 36 36 36 36 36 36 12
17 36 36 36 36 36 36 36 36 36 36 36 36 36 12
17 36 36 36 36 36 36 36 36 36 36 36 36 36 12
42 44 44 25 36 36 36 36 36 36 36 36 36 36 12
00 00 00 17 36 36 36 36 36 36 36 36 36 36 12
00 00 00 17 36 36 36 36 36 36 36 36 36 36 12
00 00 00 17 36 36 36 36 36 36 36 36 36 36 12
00 00 00 17 36 36 36 36 36 36 36 36 36 36 12
00 00 00 17 36 36 36 36 36 36 36 36 36 36 12
00 00 00 17 36 36 36 36 36 36 36 36 36 36 12
00 00 00 42 44 44 44 44 44 44 44 44 44 44 45